####################
####################
#  H H H H H H H H #
#   H H H H H H H  #
#//////////////////#
#                  #
#                  #
#H               H #
#/###############/##
#  H     H    H    #
#                  #
###/#####/####/#####
# H  H     /    H  #
#          /       #
#          /       #
## ## ########## ###
#                  #
#                  #
#        X         #
####################